                                
  #########    ########  ####### 
  ##     ##    #         #      
  ##############         #      
  #      ##    ################# 
  #      ##    #         #      
  #########    ########  ######$ 
                                
